NO ./textures/north.xpm
SO ./textures/south.xpm
WE ./textures/west.xpm
EA ./textures/east.xpm
F 220,111,119
C 225,111,0

          
     11111  
    100S001
     10001
      121
       1
