NO ./textures/north.xpm
SO ./textures/south.xpm
WE ./textures/west.xpm
EA ./textures/east.xpm

F 200,20,200
C 171,154,137


1111111111111111111
1001001001001001001
1001001001001001001
1001001001001001001
1001001000000001001
1000010000000000001
1000011111111000001
1111000000000001111
1000000101010000001
1111111111111111111

